##############################################################################################################
#                      ##########                                                                            #
#                      ##########                                                                            #
#      o o o o o o o   ##########  o o o o o o o o o o o o o o o o o o o o o o o o o o o o o o o o o o o X   #
#                  o   ##########  o             o                             o                         o   #
#  o   ##########  o   ##########  o   ########  o   ########################  o   ####################  o   #
#  o   ##########  o   ##########  o   ########  o   ########################  o   ####################  o   #
#  o               o               o   ########  o                             o                         o   #
#  o               o               o   ########  o                             o                         o   #
#  o o o o o o o o X o o o o o o o o o ########  o o o o o o o o o o o o o o o o o o o o o o o o o o o o o   #
#                                      ########  o                                                       o   #
###############################################  o   ##################################################  o   #
###############################################  o   ##                ################################  o   #
                                             ##  o   ##                ##                                o    
                                             ##  o   ##                ##                                o    
 o X o o o o o o o o o o o o o o o o o o o   ##  o   ##                ##  o o o o o o o o o o o o o o o X    
                                         o   ##  o   ##                ##   o                            o    
#######################################  o   ##  o   ####################   o  ########################  o   #
#######################################  o   ##  o   ####################   o  ########################  o   #
#                                        o       o                          o                            o   #
#                                        o       o                          o                            o   #
#   X o o o o o o o o o o o o o o o o o o o o o o o o o o o o o o o o o o o o o o o o o o o o o o o o o o o  #
#   o                                    o                                                                o  #
#   o  ################################  o   ##########################################################   o  #
#   o  ################################  o   ##########################################################   o  #
#   o                                    o                                                                o  #
#   o                                    o                                                                o  #
#   o o o o o o o o o o o o o o o o o o o o o o o o o o o o o o o o o o o o o o o o o o o o o o o o o o o X  #
#                                        o                                                                o  #
#######################################  o   ##########################################################   o  #
#######################################  o   ##########################################################   o  #
                                         o                                                                o   
                                         o                                                                o   
 o o o o o o o o o o o o o o o o o o o o X o o o o o o o o o o o o o o o o o o o o o o o o o o o o o o o o o  
                                                                                                              
##############################################################################################################
##############################################################################################################